   __  _                _  ___  ___             __   
  / / | |              (_) |  \/  |             \ \  
 / /  | |     ___  _ __ _  | .  . | __ _ _ __    \ \ 
< <   | |    / _ \| '__| | | |\/| |/ _` | '_ \    > >
 \ \  | |___| (_) | |  | |_| |  | | (_| | |_) |  / / 
  \_\ \_____/\___/| |  |_(_)_|  |_/\__,_| .__/  /_/  
 =================|_|===================|_|======== 